#################################################
#                                               #
#                                               #
#                                               #
#                                               #
#                                               #
#                                               #
#                 #############                 #
#                                               #
#                                               #
#                                               #
#                                               #
#         #                          ###        #
#                                    ###        #
#                                    ###        #
#                                    ###        #
#                                               #
#                                               #
#                                               #
#################################################
                                                 
Timer:                                           
                                                 
                                                 
                                                 
